~~~~~~~~~~~~~~~~~~~~~~~~~~~~~~~~~~~~~~~~~~~~~~~~~~~~~~~~~~~~~~~~~~~~~~~~~~~~~~
Lesson 1.1: Moving the cursor
Instructions: Follow the line around the screen using h, j, k and l.
|             Hint: if you accidentally start typing text, press Esc          
|       .-------.   to leave insert mode and u to undo any changes.           
|       |       |                                                             
\_______/       |                                                             
                |                                                             
                |                                                             
                \____.                                                        
                     |    .-----------------.                                 
                     |    |                 |                                 
           .---------+----+----.            |                                 
           \_________/    |    |            |                                 
                          |    |            |                                 
                          |    |            |                                 
                          |    \________.   \________ Well done!              
                          |             |                                     
                          |             |                                     
                          |             |                                     
                          \_____________/                                     

Credit:
https://github.com/skilldrick/vim-exercises
